monastery=修道院，僧侣
skunk=臭鼬，讨厌的人，使惨败
presidio=要塞，充军地
adobe=黏土
ceviche=酸橘汁腌鱼
aura=光环(halo)
oust=驱逐，轰走
ovation=热烈欢迎(n.)
brood=孵蛋，思考(brood over)
phony=假的
flummox=使困惑，使混乱(confound)
pompous=自大的，浮夸的
stanch=止血，止流，平息；坚固的，忠诚的
demagogue=政治煽动者
slithery=滑的（slippery）
crux=关键，难点
cashew=腰果
dog day=三伏天
itinerary=旅程路线
myopic=近视的
trove=宝藏 (a trove of)
feudalism=封建主义
fathom=看穿，彻底了解；(水深单位)英寻
boon=恩惠；愉快的
platitude=陈词滥调（a trite or obvious remark）
chary=谨慎的
perspicacious=有洞察力的
galvanize=刺激；镀锌
prescient=预知的，有先见之明的
in relief=突出的，鲜明的
sly=狡猾的，诡秘的
warble=用颤音唱
didactic=说教的
secular=尘世的，世俗的(mundane,worldly)
eschew=避开，回避（elude,evade,shun）
taboo=禁忌
foment=煽动(犯罪) abet
abeyance=搁置，暂时中止
profess=自称，声称
renounce=声明放弃/声明断绝
teem with=充满(abound with)
curtail=缩减
repertoire=全部剧目或某种题材的集合piano repertoire
dextral=右手的（sinistral左手的）
yacht=游艇
tuxedo=无尾燕尾服
sear=烤焦，使枯萎
hush money=封口费（hush停止说话）
pat-down=摸身搜查
clench=握紧（grasp）
butler=男管家
sprinkle=撒，洒；小雨；糖霜
jersey=运动衫，球衣
shanty=棚屋，简陋的屋子(shanty town)
chubby=圆胖的，胖乎乎的
monogamous=一夫一妻制的（monogamy vs. polygamy）
pluck=拔掉，采摘；胆识，勇气
athritis=关节炎
antler=鹿角
yak=西藏牦牛
surrogate=代理人
handcuffs=手铐
pariah=贫民，贱民
pneumonia=肺炎
riveting=吸引人的 (rivet铆钉)
recess=休息
terrace=阳台，平台
armpit=腋窝(armpit hair腋毛)
cornrow=黑人辫，玉米辫 (braids)
deodorant=除臭剂，体香剂
lesion=病变，损害
rumble=发飙；隆隆作响
obnoxious=讨厌的，可憎的
courier=通讯员，送信的人
gavel=(法官用的)小木锤
strew=散播
desist=中止（cease）
turban=穆斯林头巾
pumphlet=小册子(booklet,tract)
tantrum=发怒(n.)
crouton=面包丁
bootleg=违法的，盗版的(光碟)
preach=说教，传道，宣扬
stale=走味的，陈腐的，陈旧的，不新鲜的
floss=牙线
sump=污水坑
puddle=水坑（a puddle of milk一滩牛奶）
culinary=烹饪的
derby=赛马；圆礼帽(bowler)
vaudeville=杂耍，滑稽歌舞表演
nosy=好管闲事的
testicle=睾丸
mingle=混合；社交，交往
sassy=活泼的，厚脸皮的(cheeky)
pout=噘嘴
